1. Sacraments and Rituals:

Eucharist: Eucharistia, Corpus Christi, Transsubstantiatio
Baptism: Baptismus, Renovatio, Ablutio
Confession: Confessio, Absolutio, Paenitentia
Mass: Missa, Altare, Liturgia
Sacraments in general: Sacramentum, Sacramentalis, Signum

2. Theological Debates:

Justification: Iustificatio, Gratia, Fides
Predestination: Praedestinatio, Electi, Reprobatio
Grace: Gratia, Donum, Auxilium
Faith and Works: Fides, Opera, Bonum Opus, Meritum, Bona Acta
Original Sin: Peccatum, Concupiscentia, Damnatio

3. Church Hierarchy and Authority:

Pope: Papa, Pontifex, Vicarius
Cardinals: Cardinalis, Collegium
Bishops: Episcopus, Diocesis, Ordinatio
Priests: Sacerdos, Presbyter, Missio
Papal Infallibility: Ex cathedra, Dogma, Ipse dixit
 
4. Controversial Figures and Movements:

Martin Luther: Martinus Lutherus, Protestantismus, Lutheranismus (?)
John Calvin: Ioannes Calvinus, Calvinismus, Predestinatio
Counter-Reformation: Contrareformatio, Tridentinus, Concilium, Societas Jesu
Jesuits: Societas Iesu, Ignatius de Loyola, Collegium Romanum, Jesuitae
Council of Trento: Concilium Tridentinum, Decreta, Reformatio

5. Biblical Themes:

Creation: Creatio, Genesis, Mundus
Fall of Man: Peccatum, Adam et Eva, Paradisus
Redemption: Redemptio, Salvatio, Passio
Miracles: Miracula, Virtus, Prodigi, Monstra
Parables: Parabola, Similitudo, Exemplum

6. Religious Persecution and Martyrdom:

Inquisition: Inquisitio, Haereticus
Martyrdom: Martyrium, Passio, Martyr

7. Devotional Practices:

Rosary: Rosarium, Ave Maria, Mysteries
Pilgrimage: Peregrinatio, Sanctuarium, Reliquiae
Saints: Sanctus, Sanctorum, Intercessio
Virgin Mary: Virgo Maria, Regina Caeli, Theotokos
Prayers: Oratio, Pater Noster, Ave Maria